C 177  ,   220 ,   252

    

R  2147483 2147483


NO      ../txtrs/nord.xpm                   


SO ../txtrs/south.xpm

EA          ../txtrs/east.xpm



WE                  ../txtrs/west.xpm

S           ../txtrs/lamp.xpm               
F  000, 000, 00



111111111111111111111111111111
111111111000200000000000011111
100000000000000000111000100001
110000100000000000000000001111
100001111111000000020000111111
1111111000000000W0000000000001
111100000000001100000002000011
1                            1
110000000000011110000000000011
100000000000111000000000000011
11000000000011100000000000111100
110000000001111000000000000111
111111111111111111111111111111111
