
NO      ./txtrs/nord.xpm     

		
         

SO ./txtrs/south.xpm

EA          ./txtrs/east.xpm

F 97,   097,       097        			

WE                  ./txtrs/west.xpm
S           ./txtrs/barrel.xpm


R  800 600




C                       0         ,   0             ,   0
				
					
              11111111111111111111111111
              100000000000000000000000001
11111111111111101111111111111111111111001  
100000000211000000000001              1001
102200002111000000000001               1001
100200000000000000000001      11111     101
102002000111000000000001      12221     101
100022000211000001110111      10001     101
100221111011111111000001      10001     101
101101111010101011010101      10001     101
110000001001010111000001     12021      101
100000000000000011000001    10001       101
100000000000000011010101    10001       1001
110000001101010111110111    10001        101
111101111111011112220221    10001        101
111101111111001012000001    10001        101
110000001110000012000001    10001        101
100000001100000011000001    10001        101
100000000001111011100011    10001        101
100000001111111110010101111110001      111021
110000000000011010000000000000021      120021
100000111000001101010101111111111      120N01
100002211000000000000001               111111    
10000001 100001101010101                 
11000001 100011010100011
11111111 11111111111111
    
