
NO      ../txtrs/nord.xpm     

		
         

SO ../txtrs/south.xpm

EA          ../txtrs/east.xpm

F 97,   097,       097        			

WE                  ../txtrs/west.xpm
S           ../txtrs/barrel.xpm


R  1000000 100000000




C                       000177         ,   0220             ,   252
				
					
				

111111111111111 11111111
100000000211000100000001
102200002111000000000001
100200000000000000000001      11111
102002000111000000000001      101 1
100022000211000001110111       1
100221111111111111000001
111101111010101011010101
110000001101010111000001
100000000000000011000001
100000000000000011010101
110000001101010111110111
111101111111011112220221
111101111111001012000001
110000011100000012000001
100000001100000011000001
100000001111111011100011
100000001111111110010101
110000000000011010100011
100000111000001101010101
1000022110000S0000000001
10000001 100001101010101
11000001 100011010100011
11111111 111111111111111

