
NO      ../txtrs/nord.xpm     

		
         

SO ../txtrs/south.xpm

EA          ../txtrs/east.xpm

F 97,   097,       097        			

WE                  ../txtrs/west.xpm
S           ../txtrs/lamp.xpm


R  1000000 100000000




C                       000177         ,   0220             ,   252
				
					
				

111111111111111111111111
100000000211000000000001
102200002111000000000001
100200000000000000000001
102002000111000000000001
100022000211000001110111
100221111111111111000001
111101111010101011010101
110000001101010111000001
100000000000000011000001
100000000000000011010101
110000001101010111110111
111101111111011112220221
111101111111001012000001
110000011100000012000001
100000001100000011000001
100000001111111011100011
100000001111111110010101
110000011100011010100011
100000001000001101010101
100000000000000000000001
100000001000001101010101
110000011100011010100011
111111111111111111111111

